GGGGGGGGGGGGGGGG
ZXZXZXZXZXZXZXZX
CVCVCVCVCVCVCVCV
GGGGGGGGGGGGGGGG
ZXZXZXZXZXZXZXZX
CVCVCVCVCVCVCVCV
ZXZXZXZXGGGGGGGG
CVCVCVCVCVCVCVCV
ZXGGGGZXZXZXZXZX
CVCVCVCVCVCVCVCV
ZXZXZXZXZXGGGGGG
GGGGGGGGCVCVCVCV
ZXZXZXZXZXZXZXZX
CVCVCVGGGGGGCVCV
ZXZXZXZXZXZXZXZX
GGGGGGCVCVCVCVCV
ZXZXZXZXGGGGGGGG
CVCVCVCVCVCVCVCV
GGGGGGGGGGGGGGGG
